0000000000000000000000
0000020000000000000000
0000000400000000000000
0000000000000000000000
0000001111000000000000
0000000000010000003000
0000016560010020000000
0000010000010000000000
0000011111110000011111
0200000000000000000000
0000300000001111100000
0000000000001000040000
0000000000001080807000
0004000000001111111101
0000000000000000030000
0000000000000000000000

